# Nombre de couches
2
# Hauteur
20
# Largeur
20
# Couche 0
46 46 46 46 46 46 46 46 46 46 46 46 46 46 46 46 46 46 46 46 
46 46 46 46 46 46 46 46 46 46 46 46 46 46 46 46 46 46 46 46 
46 46 46 46 46 46 46 46 46 46 46 46 46 46 46 46 46 46 46 46 
46 46 46 46 46 46 46 46 46 46 46 46 46 46 46 46 46 46 46 46 
46 46 46 46 46 46 46 46 46 46 46 46 46 46 46 46 46 46 46 46 
46 46 46 46 46 46 46 46 46 46 46 46 46 46 46 46 46 46 46 46 
46 46 46 46 46 46 46 46 46 46 46 46 46 46 46 46 46 46 46 46 
46 46 46 46 46 46 46 46 46 46 46 46 46 46 46 46 46 46 46 46 
46 46 46 46 46 46 46 46 46 46 46 46 46 46 46 46 46 46 46 46 
46 46 46 46 46 46 46 46 46 46 46 46 46 46 46 46 46 46 46 46 
46 46 46 46 46 46 46 46 46 46 46 46 46 46 46 46 46 46 46 46 
46 46 46 46 46 46 46 46 46 46 46 46 46 46 46 46 46 46 46 46 
46 46 46 46 46 46 46 46 46 46 46 46 46 46 46 46 46 46 46 46 
46 46 46 46 46 46 46 46 46 46 46 46 46 46 46 46 46 46 46 46 
46 46 46 46 46 46 46 46 46 46 46 46 46 46 46 46 46 46 46 46 
46 46 46 46 46 46 46 46 46 46 46 46 46 46 46 46 46 46 46 46 
46 46 46 46 46 46 46 46 46 46 46 46 46 46 46 46 46 46 46 46 
46 46 46 46 46 46 46 46 46 46 46 46 46 46 46 46 46 46 46 46 
46 46 46 46 46 46 46 46 46 46 46 46 46 46 46 46 46 46 46 46 
46 46 46 46 46 46 46 46 46 46 46 46 46 46 46 46 46 46 46 46
# Couche 1
0 0 0 0 0 0 0 0 0 0 0 0 0 0 0 0 0 0 0 0 
0 0 0 0 0 0 0 0 0 0 0 0 0 0 0 0 0 0 0 0 
0 0 0 0 0 0 0 0 0 0 0 0 0 0 0 0 0 126 0 0 
0 0 0 0 0 0 0 0 0 0 0 0 0 0 0 0 0 148 0 0 
0 0 55 56 0 0 0 0 0 0 0 0 0 0 0 0 0 0 0 126 
0 0 77 78 0 0 55 56 0 0 0 0 55 56 0 0 55 56 0 148 
0 0 0 0 0 0 77 78 0 0 0 0 77 78 0 147 77 78 0 0 
0 0 147 0 0 0 0 0 0 0 0 100 0 0 0 240 241 0 0 0 
0 0 0 0 55 56 0 0 228 229 230 0 0 0 0 262 263 0 0 0 
0 0 0 0 77 78 0 0 250 251 252 0 0 0 0 0 0 55 56 0 
0 0 0 0 0 0 0 0 272 273 274 99 0 0 0 0 0 77 78 0 
0 0 72 73 0 147 0 0 0 0 0 0 0 72 73 0 0 0 147 0 
0 0 94 95 0 0 0 0 0 0 0 0 0 94 95 0 0 0 0 0 
0 0 0 0 0 0 0 0 72 73 0 0 0 0 0 0 0 0 0 0 
0 0 0 0 0 0 0 0 94 95 0 0 0 0 0 0 0 0 0 0 
0 0 0 0 0 0 0 0 0 0 0 0 0 0 0 0 0 0 0 0 
0 0 0 0 0 0 0 0 0 0 0 0 0 0 0 0 0 0 0 0 
0 0 0 0 0 0 0 0 0 0 0 0 0 0 0 0 0 0 0 0 
0 0 0 0 0 0 0 0 0 0 0 0 0 0 0 0 0 0 0 0 
0 0 0 0 0 0 0 0 0 0 0 0 0 0 0 0 0 0 0 0