# Nombre de couches
2
# Hauteur
20
# Largeur
20
# Couche 0
1 1 1 1 1 1 1 1 1 1 1 1 1 1 1 1 1 1 1 1 
1 1 1 1 1 1 1 1 1 1 1 1 1 1 1 1 1 1 1 1 
1 1 1 1 1 1 1 1 1 1 1 1 1 1 1 1 1 1 1 1 
1 1 1 1 1 1 1 1 1 1 1 1 1 1 1 1 1 1 1 1 
1 1 1 1 1 1 1 1 1 1 1 1 1 1 1 1 1 1 1 1 
1 1 1 1 1 1 1 1 1 1 1 1 1 1 1 1 1 1 1 1 
1 1 1 1 1 1 1 1 1 1 1 1 1 1 1 1 1 1 1 1 
1 1 1 1 1 1 1 1 1 1 1 1 1 1 1 1 1 1 1 1 
1 1 1 1 1 1 1 1 1 1 1 1 1 1 1 1 1 1 1 1 
1 1 1 1 1 1 1 1 1 1 1 1 1 1 1 1 1 1 1 1 
1 1 1 1 1 1 1 1 1 1 1 1 1 1 1 1 1 1 1 1 
1 1 1 1 1 1 1 1 1 1 1 1 1 1 1 1 1 1 1 1 
1 1 1 1 1 1 1 1 1 1 1 1 1 1 1 1 1 1 1 1 
1 1 1 1 1 1 1 1 1 1 1 1 1 1 1 1 1 1 1 1 
1 1 1 1 1 1 1 1 1 1 1 1 1 1 1 1 1 1 1 1 
1 1 1 1 1 1 1 1 1 1 1 1 1 1 1 1 1 1 1 1 
1 1 1 1 1 1 1 1 1 1 1 1 1 1 1 1 1 1 1 1 
1 1 1 1 1 1 1 1 1 1 1 1 1 1 1 1 1 1 1 1 
1 1 1 1 1 1 1 1 1 1 1 1 1 1 1 1 1 1 1 1 
1 1 1 1 1 1 1 1 1 1 1 1 1 1 1 1 1 1 1 1
# Couche 1
0 0 0 0 0 0 0 0 0 0 0 0 0 0 0 0 0 0 0 0 
0 0 0 0 0 0 0 0 0 0 0 0 715 716 717 0 0 0 0 0 
0 0 0 0 0 0 0 0 0 0 0 0 769 770 771 0 0 0 0 0 
0 0 0 0 0 0 0 0 0 0 0 0 823 824 825 0 0 0 0 0 
0 0 715 716 717 0 0 0 0 0 0 0 877 878 879 932 0 0 0 0 
0 0 769 770 771 0 0 0 0 0 0 0 0 932 0 0 0 0 0 0 
0 0 823 824 825 0 0 0 0 644 645 646 647 648 0 0 0 0 0 0 
0 0 877 878 879 932 0 0 0 698 699 700 701 702 0 0 715 716 717 0 
0 0 932 0 0 0 0 0 0 752 753 754 755 756 0 0 769 770 771 0 
0 0 0 0 0 0 0 0 0 806 807 808 809 810 0 0 823 824 825 0 
0 0 0 0 0 715 716 717 0 860 861 862 863 864 0 0 877 878 879 0 
0 0 0 0 0 769 770 771 0 914 915 916 917 918 0 0 932 0 0 0 
0 0 0 0 0 823 824 825 0 968 969 970 971 972 0 0 0 932 0 0 
0 0 0 0 0 877 878 879 0 1022 1023 1024 1025 1026 0 0 0 0 0 0 
0 0 0 0 0 0 932 0 0 0 0 0 0 0 0 0 0 0 0 0 
0 0 0 0 0 0 0 0 0 0 0 0 0 0 0 0 0 0 0 0 
0 0 0 0 0 0 0 0 0 0 0 0 0 0 0 0 0 0 0 0 
0 0 0 0 0 0 0 0 0 0 0 0 0 0 0 0 0 0 0 0 
0 0 0 0 0 0 0 0 0 0 0 0 0 0 0 0 0 0 0 0 
0 0 0 0 0 0 0 0 0 0 0 0 0 0 0 0 0 0 0 0